16 16

6 4 2
1 1 4 1
1 6 1
1 3 1 1

1 1 2 1
1 1 1 1
1 1 1 1
1 1 1 1

1 1 1 1
1 2 1 1
1 1 2 1 1
1 1 2 1

1 1 1 1
1 2 1 1
1 3 1
2 2 9

16
1 1
1
1 6

1 3 3
1 2 2 1
1 1 1
2 2 1

1 2 2 1
4 2 1
5 2 1
3 2 1

3 1
1
1 1
16